WWWWWWWW
W00WWWWW
WX0WX00W
W000000W
W000X0WW
W00WX00W
WWWWWWWW
1,1
3,1
3,2
4,3
4,5 
